*          B
* ********* 
* *       * 
* * ***** * 
*   *     * 
*** * ***** 
A   *       
